NO textures/nrth.xpm
SO  textures/south.xpm      
                        WE textures/west.xpm
        EA textures/east.xpm

        F   5,       5       ,   3
C    200,          200,200
11111
10001
10001                
10001
10S01
10101
11001              
100011111111111111110111111
10001
10001
10001
10001
1110           

    