NO textures/nrth.xpm
SO textures/south.xpm
WE textures/west.xpm
EA textures/east.xpm

F 220,100,0
C 255,255,255

11111
10001
10S01
10001
11111
