NO textures/nrth.xpm
SO textures/south.xpm
WE textures/west.xpm
EA textures/east.xpm

F 256,100,0
C 0,0,0

11111
10001
10S01
10001
11111
